Baboon hawk=タカヒヒ
Bracken=シダ男
Bunker spider=バンカースパイダー
Butler=執事
Circuit bees=電気ミツバチ
Coil-head=バネ頭
Earth leviathan=リヴァイアサン
Eyeless dog=目無し犬
Forest Giant=森の番人
Forest keeper=森の番人
Ghost girl=女の子の幽霊
Half=ハーフ
Hoarding bug=ため込み虫
Hygrodere=スライム
Jeb=ジェブ
Jester=道化師
LASSO=投げ縄男
Landmine=地雷
Lasso Man=投げ縄男
Manticoil=マンティコイル
Mask Hornets=仮面スズメバチ
Masked=マスク
Masks=マスク
Old Bird=オールドバード
Roaming locusts=飛び回るバッタ
Snare flea=潜伏ムカデ
Spore lizard=胞子トカゲ
Thumper=サンパー
Tulip Snake=チューリップスネーク
Turret=タレット
Nutcracker=くるみ割り人形